................................................................................
..................................................................##............
..................................................................####..........
..............#######............................................#####..........
..........################.......................................#####..........
.........###################................................############........
........######...##...######................#####...........##################..
........#####..##....#####.............#############################............
.........##############.#...............######################..................
............#####.###...........................###############.................
..........................................................########..............
............................................................#######.............
..............................................................#######...........
...............................................................######...........
...........................#############.......................#######..........
.......########.........######.......####.......................######..........
......###########......############...######....................######..........
........##########.....##############......####.................#####...........
............######.....##############.........###................#####..........
............#####........##############.........###..............#####..........
............####..........###############.......####................##..........
...........####............##############.......#####...........................
........######.................############.....#####...........................
........######......................########..#######...........................
........######.........................#############............................
.........######.................................................................
...........####.................................................................
............###................##...............................................
.......##########..............####.............................................
..........#########...............######........................................
..........###########................######.....................................
...............#######..................####....................................
....................##....................####..................................
.............................................###....#.#.#.......................
.............................................############..........###..........
............................................##########.............#####........
..........................................####.....................######.......
..####.............................................................######.......
....######.........................................................#######......
.......######......................................................#######......
.........######..................................................#########......
............#####.............................................###########.......
..............#####.......................................################......
................##.###...................................##############.........
..................########...............................###################....
.....................#########............................#############.........
.........................#############..........................######..........
..............................#################.................................
.....................................##########.................................
................................................................................
................................................................................
................................................................................
